10 28
wwwwwwwwwwwwwwwwwwwwwwwwwwww
####                       #
####f        !      +      #
#  ##k                    D#
#  ####       R       ##   #
#         +   #  # #       #
#    k   ## #            ###
#   ###                    #
# /        #    R     +    #
############################ 