10 36
####################################
#R     +            +        #    ##
#               !            #     D
#@  @       -@     /   #     #  #@##
#     j  @    #       ##     #  # ##
#        #    #  @@@@ #  #####  ####
#    +   # @  #       #  #   R#  k##
#       +#    # +++++ #    #     ###
#        #+  @#       #   #+    # ##
####################################
